name Maze
win 3
########################
#.........#............#
#..#...G..#.....E.#...##
##.####...#..######....#
#..EG..#..#............#
######.#..#G.######....#
#......#..#......#.....#
#.#######.#.######.....#
#.....................##
########################